
C 0,0,0
F 0,0,0

EA textures/east.xpm
NO textures/north.xpm
SO textures/south.xpm
WE textures/west.xpm


111
101
11E1
11111
