	EA      textures/east.xpm
	NO              textures/north.xpm
 SO        textures/south.xpm
		WE                              textures/west.xpm

F 210,180,140
C 75,144,226

11111111111111
10000000000001
10000000000001
100D000N0D0001
10000000000001
10000000000001
11111111111111
