EA     textures/east.xpm
NO     textures/north.xpm
SO     textures/south.xpm
WE     textures/west.xpm

F 255,255,255
C 255,150,0

11111111111111
10010000010001
100D000N0D0001
10010000010001
11111111111111