EA assets/textures/dragonball.png
NO assets/textures/dragonball.png
SO assets/textures/dragonball.png
WE assets/textures/dragonball.png


F 255,255,255
C 255,150,0

11111111111111
10010000000001
100D000N000001
10010000000001
11111111111111